MapName Field
TileSize 32
Pallete 5
Tile 0 1 0
Tile 1 0 0
Tile 2 1 0
Tile 3 1 0
Tile 4 0 1
MapData 8 8
0,0,0,0,0,0,0,0
0,1,1,1,1,1,1,0
0,1,1,2,2,1,1,0
0,1,1,2,2,1,1,0
0,1,1,1,1,1,1,3
0,1,1,1,1,1,3,3
0,1,1,1,1,4,3,3
0,0,0,0,3,3,3,3
Warps 1
House 5 6 1 1