MapName House
TileSize 32
Pallete 5
Tile 0 1 0
Tile 1 0 0
Tile 2 1 0
Tile 3 1 0
Tile 4 0 1
MapData 12 8
0,0,0,0,0,0,0,0,0,0,0,0
0,4,1,1,1,1,1,1,1,1,1,0
0,1,0,0,0,0,1,0,0,0,1,0
0,1,0,1,0,1,1,0,1,0,1,0
0,1,1,1,1,1,0,0,1,1,1,0
0,1,0,0,0,1,0,0,0,0,1,0
0,1,1,1,1,1,1,1,1,1,1,0
0,0,0,0,0,0,0,0,0,0,0,0
Warps 1
Field 1 1 5 6