TileSize 32
MapSize 8 8
PalleteSize 5
Pallete
Tile 0 1 
Tile 1 0
Tile 2 1
Tile 3 1
Tile 4 0
MapData 
0,0,0,0,0,0,0,0
0,1,1,1,1,1,1,0
0,1,1,2,2,1,1,0
0,1,1,2,2,1,1,0
0,1,1,1,1,1,1,3
0,1,1,1,1,1,3,3
0,1,1,1,1,4,3,3
0,0,0,0,3,3,3,3