MapName GameMap
TileSize 16
Pallete 26
Tile 0 0 0
Tile 1 1 0
Tile 2 1 0
Tile 3 1 0
Tile 4 1 0
Tile 5 1 0
Tile 6 1 0
Tile 7 1 0
Tile 8 1 0
Tile 9 1 0
Tile 10 0 0
Tile 11 1 0
Tile 12 1 0
Tile 13 1 0
Tile 14 1 0
Tile 15 1 0
Tile 16 1 0
Tile 17 1 0
Tile 18 1 0
Tile 19 1 0
Tile 20 0 0
Tile 21 1 0
Tile 22 1 0
Tile 23 1 0
Tile 24 1 0
Tile 25 1 0
MapData 28 31
14,12,12,12,12,12,12,12,12,12,12,12,12,22,23,12,12,12,12,12,12,12,12,12,12,12,12,15
13,00,00,00,00,00,00,00,00,00,00,00,00,06,06,00,00,00,00,00,00,00,00,00,00,00,00,13
13,00,01,05,05,02,00,01,05,05,05,02,00,06,06,00,01,05,05,05,02,00,01,05,05,02,00,13
13,00,06,00,00,06,00,06,00,00,00,06,00,06,06,00,06,00,00,00,06,00,06,00,00,06,00,13
13,00,03,05,05,04,00,03,05,05,05,04,00,03,04,00,03,05,05,05,04,00,03,05,05,04,00,13
13,00,00,00,00,00,00,00,00,00,00,00,00,00,00,00,00,00,00,00,00,00,00,00,00,00,00,13
13,00,01,05,05,02,00,01,02,00,01,05,05,05,05,05,05,02,00,01,02,00,01,05,05,02,00,13
13,00,03,05,05,04,00,06,06,00,03,05,05,02,01,05,05,04,00,06,06,00,03,05,05,04,00,13
13,00,00,00,00,00,00,06,06,00,00,00,00,06,06,00,00,00,00,06,06,00,00,00,00,00,00,13
16,12,12,12,12,15,00,06,03,05,05,02,00,06,06,00,01,05,05,04,06,00,14,12,12,12,12,17
00,00,00,00,00,13,00,06,01,05,05,04,00,03,04,00,03,05,05,02,06,00,13,00,00,00,00,00
00,00,00,00,00,13,00,06,06,00,00,00,00,00,00,00,00,00,00,06,06,00,13,00,00,00,00,00
00,00,00,00,00,13,00,06,06,00,08,12,12,07,07,12,12,09,00,06,06,00,13,00,00,00,00,00
12,12,12,12,12,17,00,03,04,00,13,00,00,00,00,00,00,13,00,03,04,00,16,12,12,12,12,12
00,00,00,00,00,00,00,00,00,00,13,00,00,00,00,00,00,13,00,00,00,00,00,00,00,00,00,00
12,12,12,12,12,15,00,01,02,00,13,00,00,00,00,00,00,13,00,01,02,00,14,12,12,12,12,12
00,00,00,00,00,13,00,06,06,00,10,12,12,12,12,12,12,11,00,06,06,00,13,00,00,00,00,00
00,00,00,00,00,13,00,06,06,00,00,00,00,00,00,00,00,00,00,06,06,00,13,00,00,00,00,00
00,00,00,00,00,13,00,06,06,00,01,05,05,05,05,05,05,02,00,06,06,00,13,00,00,00,00,00
14,12,12,12,12,17,00,03,04,00,03,05,05,02,01,05,05,04,00,03,04,00,16,12,12,12,12,15
13,00,00,00,00,00,00,00,00,00,00,00,00,06,06,00,00,00,00,00,00,00,00,00,00,00,00,13
13,00,01,05,05,02,00,01,05,05,05,02,00,06,06,00,01,05,05,05,02,00,01,05,05,02,00,13
13,00,03,05,02,06,00,03,05,05,05,04,00,03,04,00,03,05,05,05,04,00,06,01,05,04,00,13
13,00,00,00,06,06,00,00,00,00,00,00,00,00,00,00,00,00,00,00,00,00,06,06,00,00,00,13
18,05,02,00,06,06,00,01,02,00,01,05,05,05,05,05,05,02,00,01,02,00,06,06,00,01,05,19
20,05,04,00,03,04,00,06,06,00,03,05,05,02,01,05,05,04,00,06,06,00,03,04,00,03,05,21
13,00,00,00,00,00,00,06,06,00,00,00,00,06,06,00,00,00,00,06,06,00,00,00,00,00,00,13
13,00,01,05,05,05,05,04,03,05,05,02,00,06,06,00,01,05,05,04,03,05,05,05,05,02,00,13
13,00,03,05,05,05,05,05,05,05,05,04,00,03,04,00,03,05,05,05,05,05,05,05,05,04,00,13
13,00,00,00,00,00,00,00,00,00,00,00,00,00,00,00,00,00,00,00,00,00,00,00,00,00,00,13
16,12,12,12,12,12,12,12,12,12,12,12,12,12,12,12,12,12,12,12,12,12,12,12,12,12,12,17