MapName GameMap
TileSize 16
Pallete 34
Tile 0 0 0
Tile 1 1 0
Tile 2 1 0
Tile 3 1 0
Tile 4 1 0
Tile 5 1 0
Tile 6 1 0
Tile 7 1 0
Tile 8 1 0
Tile 9 1 0
Tile 10 1 0
Tile 11 1 0
Tile 12 1 0
Tile 13 1 0
Tile 14 1 0
Tile 15 1 0
Tile 16 1 0
Tile 17 1 0
Tile 18 1 0
Tile 19 1 0
Tile 20 1 0
Tile 21 1 0
Tile 22 1 0
Tile 23 1 0
Tile 24 1 0
Tile 25 1 0
Tile 26 1 0
Tile 27 1 0
Tile 28 1 0
Tile 29 1 0
Tile 30 1 0
Tile 31 1 0
Tile 32 1 0
Tile 33 1 0
MapData 28 31
01,05,05,05,05,05,05,05,05,05,05,05,05,21,22,05,05,05,05,05,05,05,05,05,05,05,05,02
07,00,00,00,00,00,00,00,00,00,00,00,00,16,15,00,00,00,00,00,00,00,00,00,00,00,00,08
07,00,09,14,14,10,00,09,14,14,14,10,00,16,15,00,09,14,14,14,10,00,09,14,14,10,00,08
07,00,16,00,00,15,00,16,00,00,00,15,00,16,15,00,16,00,00,00,15,00,16,00,00,15,00,08
07,00,11,13,13,12,00,11,13,13,13,12,00,11,12,00,11,13,13,13,12,00,11,13,13,12,00,08
07,00,00,00,00,00,00,00,00,00,00,00,00,00,00,00,00,00,00,00,00,00,00,00,00,00,00,08
07,00,09,14,14,10,00,09,10,00,09,14,14,14,14,14,14,10,00,09,10,00,09,14,14,10,00,08
07,00,11,13,13,12,00,16,15,00,11,13,13,10,09,13,13,12,00,16,15,00,11,13,13,12,00,08
07,00,00,00,00,00,00,16,15,00,00,00,00,16,15,00,00,00,00,16,15,00,00,00,00,00,00,08
03,06,06,06,06,31,00,16,11,14,14,10,00,16,15,00,09,14,14,12,15,00,30,06,06,06,06,04
00,00,00,00,00,07,00,16,09,13,13,12,00,11,12,00,11,13,13,10,15,00,08,00,00,00,00,00
00,00,00,00,00,07,00,16,15,00,00,00,00,00,00,00,00,00,00,16,15,00,08,00,00,00,00,00
00,00,00,00,00,07,00,16,15,00,17,06,06,29,29,06,06,18,00,16,15,00,08,00,00,00,00,00
05,05,05,05,05,33,00,11,12,00,08,00,00,00,00,00,00,07,00,11,12,00,32,05,05,05,05,05
00,00,00,00,00,00,00,00,00,00,08,00,00,00,00,00,00,07,00,00,00,00,00,00,00,00,00,00
06,06,06,06,06,31,00,09,10,00,08,00,00,00,00,00,00,07,00,09,10,00,30,06,06,06,06,06
00,00,00,00,00,07,00,16,15,00,19,05,05,05,05,05,05,20,00,16,15,00,08,00,00,00,00,00
00,00,00,00,00,07,00,16,15,00,00,00,00,00,00,00,00,00,00,16,15,00,08,00,00,00,00,00
00,00,00,00,00,07,00,16,15,00,09,14,14,14,14,14,14,10,00,16,15,00,08,00,00,00,00,00
01,05,05,05,05,33,00,11,12,00,11,13,13,10,09,13,13,12,00,11,12,00,32,05,05,05,05,02
07,00,00,00,00,00,00,00,00,00,00,00,00,16,15,00,00,00,00,00,00,00,00,00,00,00,00,08
07,00,09,14,14,10,00,09,14,14,14,10,00,16,15,00,09,14,14,14,10,00,09,14,14,10,00,08
07,00,11,13,10,15,00,11,13,13,13,12,00,11,12,00,11,13,13,13,12,00,16,09,13,12,00,08
07,00,00,00,16,15,00,00,00,00,00,00,00,00,00,00,00,00,00,00,00,00,16,15,00,00,00,08
25,14,10,00,16,15,00,09,10,00,09,14,14,14,14,14,14,10,00,09,10,00,16,15,00,09,14,28
26,13,12,00,11,12,00,16,15,00,11,13,13,10,09,13,13,12,00,16,15,00,11,12,00,11,13,27
07,00,00,00,00,00,00,16,15,00,00,00,00,16,15,00,00,00,00,16,15,00,00,00,00,00,00,08
07,00,09,14,14,14,14,12,11,14,14,10,00,16,15,00,09,14,14,12,11,14,14,14,14,10,00,08
07,00,11,13,13,13,13,13,13,13,13,12,00,11,12,00,11,13,13,13,13,13,13,13,13,12,00,08
07,00,00,00,00,00,00,00,00,00,00,00,00,00,00,00,00,00,00,00,00,00,00,00,00,00,00,08
03,06,06,06,06,06,06,06,06,06,06,06,06,06,06,06,06,06,06,06,06,06,06,06,06,06,06,04